ITEMS:
Monstro -> Monstro's Tooth
Chub -> Little Chubby
Gurdy, Gurdy Jr., Mega Gurdy, Gurglings -> Lil Gurdy
Monstro II -> Monstro's Lung
Peep -> Free Lemonade
Loki -> Loki's Horns
Blastocyst -> Lil Spewer
Gemini -> Gemini
Fistula -> Leprosy
Fallen -> Brimstone Bombs
Carrion Queen -> Bone Spurs
Husk -> Infestation
Bloat -> Peeper
Lokii -> Lil Loki
Blighted Ovum -> Lost Soul
Teratoma -> Tinytoma
Widow -> Spiderbaby
Mask of Infamy -> Infamy
Wretched -> Juicy Sack
Daddy Long Legs -> Daddy Long Legs
Triachnid -> Spider Bite
Haunt -> Lil Haunt
Dingle -> Poop
Mega Maw -> Continuum
Gate -> Host Hat
Mega Fatty -> Thunder Thighs
Cage -> Bird Cage
Dark One -> Dark Matter
Adversary -> Eye of the Occult
Polycephalus -> Giant Cell
Mr Fred -> Harlequin Baby
Stain -> Worm Friend
Brownie -> Dirty Mind
Forsaken -> Book of the Dead
Little Horn, Big Horn -> Little Horn
Rag Man -> Box of Spiders
Dangle -> Montezuma's Revenge
Turdlings -> Number Two
Frail -> Brittle Bones
Rag Mega -> Spoon Bender
Sisters Vis -> Gimpy
Matriarch -> Big Chubby
Pile -> Compound Fracture
Reap Creep -> The Wiz
Beelzebub -> Aquarius
Wormwood -> Leech
Rainmaker -> Depression
Visage -> Empty Heart
Heretic -> Ceremonial Robes
Hornfel -> Hot Bombs
Great Gideon -> Gnawed Leaf
Scourge -> Magic Skin
Rotgut -> Yuck Heart
Minmin -> Smart Fly
Clog -> Flush
Singe -> Bird's Eye
Colostomia -> Butt Bombs
Shell -> Akeldama
Turdlet -> Brown Nugget
Clutch -> Astral Projection

TRINKETS:
Larry Jr., Scolex, Hollow, Pin -> Flat Worm
Famine -> Locust of Famine
Pestilence -> Locust of Pestilence
War -> Locust of Wrath
Death -> Locust of Death
Conquest -> Locust of Conquest
Siren -> Forgotten Lullaby
Horny Boys -> The Twins
